"run","m1de_initial","randomSeed","m1ae_initial","na_initial","m1_initial","m2_initial","n_initial"
1,0,1,0,0,0,0,0
3,0,3,0,0,0,0,0
5,0,5,0,0,0,0,0
7,0,7,0,0,0,0,0
9,0,9,0,0,0,0,0
2,0,2,0,0,0,0,0
4,0,4,0,0,0,0,0
6,0,6,0,0,0,0,0
8,0,8,0,0,0,0,0
10,0,10,0,0,0,0,0
